{
    "maps": [{
        "tileTypes": {
            ".": {
                "type": "floor"
            },
            "#": {
                "type": "wall"
            },
            "~": {
                "type": "water"
            }
        },

        "tiles": [
            "      ###########      ",
            "    ###..#...#..###    ",
            "   ##....#...#....##   ",
            "  ##.....##.##.....##  ",
            " ##.................## ",
            " #...................# ",
            "##......#..~..#......##",
            "#..........~..........#",
            "#..........~..........#",
            "####.......~.......####",
            "#..#.......~.......#..#",
            "#.......~~~~~~~.......#",
            "#..#.......~.......#..#",
            "####.......~.......####",
            "#..........~..........#",
            "#..........~..........#",
            "##......#..~..#......##",
            " #...................# ",
            " ##.................## ",
            "  ##.....##.##.....##  ",
            "   ##....#...#....##   ",
            "    ###..#...#..###    ",
            "      ###########      "
        ],

        "startPos": [11.5, 1.5]
    }]
}
